NO images/north.png
SO images/south.png
WE images/west.png
EA images/east.png

F 255,0,60
C 00,0,12


        1111111111111111111111111
        100000000011000000000001
        10110000011100000000000011
        100100000000000000000000001
1111111110110000011100000000000111
1000000000111111111101010001111111
11110111111      1110101000001
111101111101     11101010000001
11110111111      1110101000001
111101111111111111000100000011
110000001101010111000000100001
100000000000000011000000100011
1000000000N0000011010100110011
11000000100101010001110100101
11110111 111010111101101010001
11111111 1111111 1111111111111