NO textures/north.png
SO textures/south.png
WE textures/west.png
EA textures/east.png

F 255,00,22
C 00,0,255



        1111111111111111111111111
        100000000011000000000001
        1011000001110000000000001
        1001000000000000000000001
1111111110110000011100W0000000001
100000000011111111110111111111111
11110111111      11101110000001
111101111111111111000100000011
110000001101010111000000100011
100000000000000011000000100011
100000000000000011010100110011
110000001001010010001110100111
11110111 1110101 101111010001
11111111 1111111 1111111111111
