NO textures/north.png
SO textures/south.png
WE textures/west.png
EA textures/east.png

F 255, 0, 60
C 00,0, 12


        1111111111110111111111111
        100000000011000000000001
        10110000011100000000000011
        10010000000000000000000000
1111111110110000011100N00000000011
1000000000111111111101110001111111
11110111111      1110111000001
111101111101     11101110000001
11110111111      1110111000001
111101111111111111000100000011
110000001101010111000000100011
100000000000000011000000100011
100000000000000011010100110011
11000000100101010001110100111
11110111 111010111101111010001
11111111 1111111 1111111111111