NO textures/north.png
SO textures/south.png
WE textures/west.png
EA textures/east.png

F 255, 0, 60
C 00,0, 12

1111111111111111111111111
1000000000110000000000011
1011000001110000000000001
1001000000000000000000001
1111111110110000011100W001
1000000000111111111101111
1111011111111111110111001
1111011111111111110001001
1100000011010101110000001
1000000000000000110000001
1000000000000000110101001
1100000010010101000111011
1111011111101011011110101
1111111111111111111111111