NO textures/red.png
SO textures/gris.png
WE textures/gris_amarillo.png
EA textures/gris_amarillo.png

F 20,20,20
C 200,200,200

11111
10001
10S01
10001
10001
10001
11001     111111
10001     100001
10001     111111
10001
10001
10001
11111
