NO textures/red.png
SO textures/gris.png
WE textures/piedra.png
EA textures/gris_amarillo.png

F 220,100,0
C 225,30,0

1111111111111111111
1000000000000000001
10000N0000000000001
1111111111111111111
