  		 WE                            textures/piedra.png
NO  	    textures/red.png		



	SO textures/gris.png

F 		     17,38,64

EA textures/gris_amarillo.png



C 218,234,235	

1111111111111
10S0110000101
1000110000001
1000110000001
1000000000101
1111111111111
